++++++++++++++++++++++
+   +   ++ ++        +
    + +     ++++++++++
+ +   +++  ++++ +++ ++
+ +   + + ++    +++  +
+          ++  ++  + +
+++++ + +      ++  + +
+++++ +++  + + +++   +
+       +  + + S+ +  +
+++++ +  + + + +   + +
++++++++++++++++++++++